######E############
#  M #B#M##   #   #
# ##   # ## #M# # #
#M######    #   # #
#        ######## #
# ######  C#     M#
# #   ###### ####C#
# # # #C   #    ###
# #M#M#### ####   #
#M#C#    #    ### #
#C###### # ##     #
####       ########
##   ### #        #
#C ### M # ###### #
####   # #      # #
#    ### #### #   #
#M####     ## #####
#      # #      MC#
######## ##########